############
#@......s..#
#..........#
#...B......#
#..........#
############